*******
*     *
*** ***
* *   *
* *** *
*     *
*******
