*********************
* *         *       *
* * * ***** *** *** *
*   * *     *   * * *
***** *** *** *** * *
*       *   *   * * *
* * *** *** * * * * *
* *     *   * * * * *
* ******* ***** * * *
*       *   *   * * *
******* *** * *** * *
*       *   * *   * *
**** **** *** * *** *
*       *   * * *   *
* ***** *** * * * ***
*   *   * * * *     *
* *** * * * * *******
* *   *   * *       *
* * ******* ******* *
* *                 *
*********************
