*****
*   *
** **
*   *
*****
