*****************************************************************************************************
*         *     * *         *     *     *     *         *               *             *   *         *
* *** *** *** * * * ***** * * *** * *** * * * * ***** * ***** * ********* *** ******* * *** * ***** *
* *   * *     *   *     * * *   * * * *   * * * *   * *     * * *   *   *   * * *   * *     * *   * *
* * *** ********* ***** * * *** * * * ***** *** * * * ***** * * * * * * *** * * * * * *** *** *** * *
* * *     *       *     * *   * * * * *   *     * *   *     * *   *   *     * *   * *   *   *   *   *
*** * ***** ******* ***** *** * *** * * * * ***** ***** ***** *************** * *** *** ***** * *** *
*   * *   * *     * *   * * * *       * * * *     *     *     *     *   *     *   *   *     * *   * *
* *** * * * *** * * *** * * * *** ***** * *** ******* ***** ***** *** * * ******* *** ***** ***** * *
*   *   * *     * *     * *     *   *   *   *       *     *   *   *   *   *     *   *   *   *     * *
* * * *** *** ***** ***** ***** ***** ***** ******* ***** *** * *** *********** *** *** * *** *******
* * *   *     *     *     *   *       *   *   *   *     *   *   *   *     *       * * *   * *       *
* * *********** ** ** ***** * * ********* *** * * ***** *** ***** *** *** * ***** * * ***** * ***** *
* * *   *     * *   *       * * *     *     * * *       *   *   * *   *     *     * *     *     *   *
* * * * * *** * * * ******* * *** *** * * *** * ********* *** * * * * ***** ***** * *** * ******* * *
* *   *   * *   * * *     * *     *   * * *   *   *     * *   * * * *     * *   * *     * *   *   * *
* ********* ***** *** *** * ******* *** *** *** * * *** * *** * * ******* *** * ********* * * * *** *
*   *             *   *   *     *   *   *   *   * * * *   *   *   *       *   *   *     *   * * * * *
*** * ******* ***** *** ******* * *** *** ******* * * ***** ******* ******* ***** * *** ***** * * * *
* * *   *     *     * *   *   * *   *   *   *     *       * *   *         * *   * * *     *     *   *
* * *** * ***** ***** *** * * ***** * * *** * * ********* * * *** ******* * * * * * * ***** *********
*   *   * *     *   *     * *       * *   * *   *     *     *     *     *     * *   *         *     *
* *** *** * ***** * * ***** *********** * * * *** *** ************* *** * ********* *********** *** *
* *     * * *   * *     *   *         * * *   *   * *   *           *   *   *     *   *       *   * *
* *** * *** * * ******* *** * ******* *** * *** *** *** * *********** ******* *** ***** ***** *** * *
*   * * *   * * *   *   *   *   *   *   *   *   *     * *     *     *       *   *     * *   *     * *
*** *** * *** * * * * *** ***** * ***** *** * ***** * * ***** * * * **** ** *** ***** * * * ******* *
* *     *     *   * *   *     * *     *   * *   *   * *     * * * *       * *   *   *   * *     *   *
* ***** *********** *** *** * * ***** *** ***** * *** *** *** * * * ******* * *** * ********* * * ***
*     * *   *     *   *     * *     *   *     *   * *   *     * * * *       * *   *   *     * * *   *
* *** * * *** *** *** ******* ***** * * *** ******* *** ********* * * ***** * ***** * * *** * ***** *
* *   *   *   *       *     *     *   *   *             *   *     * * *   * *     * *   *   * *     *
* * ***** * * ********* *** ************* *************** * * * ***** *** * ***** * ***** *** * *** *
* *     * * * *       * * *             *     *         * * * *     *   *   *   * * *     *   * *   *
* ******* * * * ***** * * *** *** *********** * *** *** * * * ***** *** * *** * * * * ******* * *****
* *       * * *   *   *   *     *   *     *   *   *   *   * *   * *   * *     * *   * *     * *     *
* * ******* ***** * ***** * *** *** * *** * ***** *** ***** *** * * *** * *********** * *** * ***** *
* * *     * *     *     *   * *   *   * * *     * * * * *   * *   *   * * *       *   * * *       * *
* * *** *** * ********* ***** *** ***** * ***** * * * * * *** *** *** * *** *** *** *** * * ******* *
* *   *   * * *   *               *     *     * *   * * *   * *   *   *   * * *   *     *   *       *
* *** *** * * * * * * ***** ******* *** ***** * *** * * *** * * *** * *** * * *** ******* *** ***** *
* *       *     * * *     *   *   *   *     * * *   * * *   *   *   * * *   * *   *     * * *     * *
* * *************** ***** *** * * * ******* * * ***** * * ******* *** * ***** * * * ***** * ***** ***
*     *       *     *   * *   * *   *   *   *   *     * *         * * *       * * *     * *     *   *
******* ***** * ***** * * *** ******* * * * ***** ***** *********** * ***** * * * ***** * * *** *** *
*       *     * *     * *   *         *   *   *   *           *     *   *   * * *     * *   *     * *
* ******* ***** * *** * *** ******* ********* * *** ******* * * ******* * *** * ***** * ***** ***** *
*   *     *   * * * * *   *         *   *   *   *   *     * *   *       * *   * *   * *     *   *   *
* * ***** * * * * * * *** * ********* * * ******* ******* * *** * ******* * *** *** * *** ***** * ***
* *     * * *   *   *   * *           * *     *   *       * *   * *   *   *   *   *       *     *   *
******* * * ******* *** *************** *** *** *** ***** * ***** * * * * ******* * ******* ***** * *
*       * *       * * *     *     *   *   *   *   *   *   *       * *   * *     * * * *     *   * * *
********* * ***** * * *** * * *** * * *** * * *** * * ************* ***** * *** * * * * ***** * * * *
*       * *     * * *   * * *   *   *   * * *   * * *               *     * *   * *   * *   * * * * *
* *** *** *** *** * *** * ***** ******* * * *** * ******* * ************* * * *** ***** *** * * *** *
* *   *   *   *   *     * *   *       *   *   *   *       * *   *       * * * *       *     * *   * *
* *** * ***** * ********* * * ******* *********** * ********* * * ***** *** * ******* ***** * *** * *
*   * *     * *     *     * *       *           * * *     *   *   *     *   *       *       * * * * *
* * * ***** ******* * *** * ***** * *********** * * * *** * ******* ***** ********* ********* * * * *
* * * *     *       * *   * * *   *   *         *   * * *   *     * *   *   *       *   *   * *   * *
* * *** ***** ******* ***** * * ******* *********** * * ******* *** * * * * *** ***** * * * * * *** *
* *   *   *   *   *         * *   *   * *         * * *   *     *   * * * *   *       *   * * *     *
***** *** * ***** * ********* *** * * * * *** *** *** * * * *** * *** *** *** ************* * * *****
*       *   *   * *     *       *   *   *   *   * *   * *   *   * *   *   *   *         *     * *   *
* *********** * * ***** * *** ***************** * * *** *** ***** * *** *** * * ******* ******* * * *
*   *         *     *   * *   *         *     * *   *   *   *     *     *   * *   *   *       * * * *
* * * *** ***** ***** *** * * * * ***** * *** * ***** ***** * ***** ***** * ***** * * ******* *** * *
* *     *   *   *     *   * * * *   * * *   * *     *     * *   * * * *   * *     * *       *     * *
* ********* *** * ********* * * *** * * * * * ***** * *** ***** * * * * ***** ********* * ******* * *
* *       *   * *     *   * * * *   * * * * *   *   * * *     * *     * *     *       * * *     * * *
*** ***** *** * ***** * * * *** * *** * *** *** * *** * ***** * ***** * * ***** ***** * * * *** *** *
*   * *       *     * * * *     * *         *   *   *       *       * * *   *   *   *   * * *       *
* *** * *********** * * * *** *** *********** ***** * ************* * * *** *** * * ***** * *********
* *     *         * * * *   *   *     *     *     * * *         *   * *     *   * *   * * *         *
* ******* ******* * * * *** *** ***** * *** ***** * * * ******* * ********* * *** *** * * ********* *
*       *     * * * * * * *   *   *   *   *         * * *       *         * *       * *       *     *
* ***** ***** * * *** * * *** *** * ***** ************* * *************** * *** ***** ******* * *** *
*     *         *   *   * *   * * *     * *   *     *   *   *       *         *   *   *     * * *   *
***** ************* ***** * *** * ***** * *** * *** * ***** ******* * ******* * *** * * *** *** * ***
*   * *   *   *   * *   *   *         * *     * * * *     *   *     *     *   * *   * * *       *   *
* *** * * * * * * * * * * *** ********* ******* * * * ******* * *** ***** * ***** *** * *********** *
*   *   * * *   *   * * * *       *   *           *   *       * * *     * *     * *   *           * *
*** *** *** ******* * * * ********* * *************** * ******* * *** *** ***** * *************** ***
*     * *   *     * * * *     *     *               * * *       *     *   *     *             * *   *
* ***** * *** *** *** * ***** * ************ ****** * * *** *** ******* ******* ***** ******* * *** *
*       *   *   *     *       *   *     *         * * *   * * * *       *     *       *     * *   * *
* ********* *** *************** * ***** * * *** *** * *** * * * * ******* *** ********* *** * * * * *
* *           * *             * *   *   * *   * *   * *   *   * * *   *     *           * * *   * * *
* * ********* * ***** ******* * *** * *** *** *** ***** ***** * * * * ***** ************* * * ***** *
* *         * *       * *     * * * *     *   *   *   * * *   *   * *     *   *           * * *     *
* ********* *********** * ***** * * * ***** *** *** * * * * ******* ***** *** * * * ******* *** *** *
*         *         *   * *   * * * *   *   *   *   *   *   *       *   *     * * * *     * *   * * *
********* ******* * * * * * * * * * *** * *** *** * ***** *** ********* ******* * *** *** * * *** * *
*   *           * * * *   * *     *   * *   * *   * *     *     * *           * *   * *   * * * *   *
* *** *********** * * ***** ********* ***** * *** * * ***** *** * * * ******* ***** * * * * * * * ***
* *   *   *       * *     * * *     * *     *   * * *     * *   *   * * *           * * * * * * * * *
* * ***** * ******* ***** * * * *** * * ******* *** ***** *** *** *** * * ********* * * * * * * * * *
*   *     *     *       * *   * *   * *   *     *   *   *     *   * * *   *       * * * * * * * *   *
* ***** * ***** ********* ***** * *** * * * ***** *** * ******* *** * ***** ***** *** * *** * * *** *
*       *     *                 *     * *         *   *             *           *     *       *     *
*****************************************************************************************************
