***********
*     *   *
***** * * *
*       * *
* * *** * *
* *   * * *
***** *** *
*   * *   *
* *** * * *
*       * *
***********
